# # # # # # # # # 
# . . . O . . . # 
# . . . O . . . # 
# . .@. O . .X. # 
# . . . O . . . # 
# . . . O . . > # 
# # # # # # # # # 