# # # # # # # # # # # # # # # # # # # # # # # # # # # # # # # # 
# .@. . . . . . . . . . . . . . # . . . . . . . . 0 . . . . . # 
# . . . . . . . . . . . . . . . # . . . . . . . . / . . . . . # 
# . . . . . . . . . . . . . . . # . . . . . . . . / . . . . . # 
# . . . . . . . . . . . . . . . # . . . . . . . . / . . . . . # 
# . . . . . . . . . . . . . . . # . . . . . . . . / . . . . . # 
# . . . . . . . . . . . . . . . # . . . . . . . . / . . . . . # 
# . . . . . . . . . . . . . . . # . . . . . . . . / . . . . . # 
# . . . . . . . . . . . . . . . # . . . . . . . . / . . . . . # 
# . . . . . . . . . . . . . . . # . . . . . . . . / . . . . . # 
# . . . . . . . . . . . . . . . # . . . . . . . . / . . . . . # 
# . . . . . . . . . . . . . . . # . . . . . . . . / . . . . . # 
# . . . . . . . . . . . . . . . # . . . . . . . . / . . . . . # 
# . . . . . . . . . . . . . . . # . . . . . . . . / . . . . . # 
# . . . . . . . . . . . . . . . # . . . . . . . . / . . . . . # 
# . . . . . . . . . . . . . . . # . . . . . . . . / . . . . . # 
# . . . . . . . . . . . . . . . # . . . . . . . . / . . . . . # 
# . . . . . . . . . . . . . . . # . . . . . . . . / . . . . . # 
# . . . . . . . . . . . . . . . # . . . . . . . . / . . . . . # 
# . . . . . . . . . . . . . . . # . . . . . . . . / . . . . . # 
# . . . . . . . . . . . . . . . # . . . . . . . . / . . . . . # 
# . . . . . . . . . . . . . . . # . . . . . . . . .X. . . . . # 
# . . . . . . . . . . . . . . . 0#. . . . . . . . . . . . . > # 
# # # # # # # # # # # # # # # # # # # # # # # # # # # # # # # # 