# # # # # # # # # 
# .@. . # . . r # 
# . . . # . . . # 
# . . . # . . . # 
# . . . # . . . # 
# . . . R . . > # 
# # # # # # # # # 