# # # # # # # # # 
# . . . # . . r # 
# . . . # . . . # 
# . .@. # . . . # 
# . . . # . . . # 
# . . . R . . > # 
# # # # # # # # # 