# # # # # # # # # 
# .@. . O . . . # 
# . . . O .X. . # 
# . . . O . . . # 
# . . . O . . . # 
# . . . O . . > # 
# # # # # # # # # 