# # # # # # # # # 
# .@. . R r . . # 
# # # # # # # . # 
# . . . . . # . # 
# . # # # . # G # 
# . # > . . # g # 
# . # # # # # . # 
# b B . . . . . # 
# # # # # # # # # 