# # # # # # # # # 
# /@/ / / / / / # 
# / / / / / / / # 
# / / / / / / / # 
# / / / > / / / # 
# / / / / / / / # 
# / / / / / / / # 
# / / / / / / / # 
# # # # # # # # # 