# # # # # # # # # 
# .@. . # . . . # 
# . .*. Z . . . # 
# . . . # . . . # 
# . . . # . . . # 
# . . . Z . . . # 
# . . . # . . . # 
# . . . # . . . # 
# . . . Z . . . # 
# . . . # . . . # 
# . . . # . . . # 
# . . . O . . > # 
# # # # # # # # # 