# # # # # # # # # # # 
# /@/ / / / / / / Z # 
# / / / / / / / / / # 
# / / / / / / / / / # 
# / / / / / / / / / # 
# / / / / / / / / / # 
# / / / / / / / / / # 
# / / / / / / / / / # 
# / / / / / / / / / # 
# Z / / / / / / / > # 
# # # # # # # # # # # 