# # # # # # # # # # # # # # 
# .@. . . . . . . . O O b # 
# . . # # # # # # # # # # # 
# . . .X. .X. .X. .X. B > # 
# . . # # # # # # # # # # # 
# . . . . . . . . . O O b # 
# # # # # # # # # # # # # # 