# # # # # # # # # 
# . . . # . . r # 
# . . . # . . . # 
# . .@. R . . . # 
# . . . # . . . # 
# . . . # . . > # 
# # # # # # # # # 