- - - - # # # # # 
# # # # # . . . # 
# . . . # . . . # 
# . .@. R . . . # 
# . . . # r . . # 
# # # # # . . > # 
- - - - # # # # # 