# # # # # # # # # 
# . . . # . . . # 
# . . . # . . . # 
# . .@. R . . . # 
# . . . # r . . # 
# . . . # . . > # 
# # # # # # # # # 