# # # # # # # # # 
# .@. . # . . . # 
# . .*. Z . . . # 
# R # # # # Z R # 
# . . . # . . . # 
# . . . Z . . . # 
# R Z # # # # R # 
# . . . # . . . # 
# . . . Z . . . # 
# R # # # # Z R # 
# . . . . . . . # 
# . . . . . . . # 
# . . . # # # # # 
# > . . Z Z Z r # 
# # # # # # # # # 