- - # # # # # # # 
- - # . . G . > # 
- - # . O O O O # 
- - # / / / / O # 
- - # / g g / O # 
- - # / / / / O # 
# # # / / g g O # 
# .@/ / / / / O # 
# # # # # # # # # 