- # # # # # # # # # - 
- # .@. . . . . r # - 
# # R # # / # # # # # 
# . . . # / # O O O # 
# . .X. R / R O O O # 
# . . . # / # O O O # 
# # # # # / # # # # # 
- # . . . / . . > # - 
- # # # # O # # # # - 
- - - - # # # - - - - 