# # # # # # # 
# /@/ / / / # 
# / / / / / # 
# / / > / / # 
# / / / / / # 
# / / / / / # 
# # # # # # # 