# # # # # 
# /@/ / # 
# / > / # 
# / / / # 
# # # # # 