# # # # # # # # # # - 
# .@. . . . . . . # # 
# . . . # # # # . . # 
# . . . # - - # # . # 
# # . # # - - - # . # 
- - - - - # # # # . # 
- - - - - # . . . . # 
- - - - - # . . . > # 
- - - - - # # # # # # 