# # # # # # # # # # 
# .@. . . . . . . # 
# # # # # / # # # # 
- - - - # / # - - - 
- - - - # / # - - - 
- - - - # / # - - - 
# # # # # / # # # # 
# . . . . . . . > # 
# # # # # O # # # # 
- - - - # # # - - - 