# # # # # # # # # # # # # # # . # # # # # # # # # # # - 
# .@. / / / / / / / / / / / / / / / / / / / / / / . # # 
# . . . . . O . . . r . . . . R . . . . . . . . . . . # 
# / . . . . . . . . . . . . . . . . . . . . . . . . / # 
# / . b . . . . . . Z Z Z . . . Z Z Z . . O . . . . / # 
# / . B . g G . . . . . . . . . . . . . . . . . . . / # 
# / . . . . . . . . . .X. . . . . .X. . . . . . . . / # 
# / . . . . . . . . . .X. . . . . .X. . . . . . . . / # 
/ / . . . . . .*. . . . . . . . . . . . . . . . . . / / 
# / . . O . . . . . . . . . . . . . . . . . . . . . / # 
# / . . . . . . . . . . . . .*. . . . . . . . . . . / # 
# / . . . . # . . .X. . . . . . . . . .X. . . . . . / # 
# / . . . . # . . .X. . . . . . . . . .X. . . . . . / # 
# / . . . . # . . . .X. . . . . . . .X. . . . .*. . / # 
. / . . . . # . r . . .X.X.X.X.X.X.X. . . . . . . . / # 
# / . . . . # . . . . . . . . . . . . . . . . . . . / # 
# / . . . .*# . . . . . . . . . . . . . . . . r . . / # 
# . . . . . . . . . . . . . . . . . . O . . . . . . . # 
# . . / / / / / / / / / / / / / / / / / / / / / / . > # 
# # # # # # # # # # # # # # # . # # # # # # # # # # # # 