# # # # # # # # # # # # # # # # # # # # # # # 
# .@. . . . . . . . . . . . . . . . . . . . # 
# . / / . . . . / / . / / . / / . . . / / . # 
# . / / . . . . / / . / / . / / / . . / / . # 
# . / / . . . . / / . / / . / / / / . / / . # 
# . / / . / / . / / . / / . / / . / / / / . # 
# . / / / / / / / / . / / . / / . . / / / . # 
# . / / / . . / / / . / / . / / . . . / / . # 
# . / / . . . . / / . / / . / / . . . / / . # 
# . . . . . . . . . . . . . . . . . . . . . # 
# # # # # # # # # # # # # # # # # # # # # # # 